xxxxxxxxxxxxxxxxxxx
x                 x
x xxx x xxx x xxx x
x xxx x     x xxx x
x xxx x x x x xxx x
x     x x x x     x
x xxxxx x x xxxxx x
x x             x x
x x xxxxx xxxxx x x
x                 x
x xxxxx xxx xxxxx x
x       xxx       x
x xxx x xxx x xxx x
x xxx x     x xxx x
x xxx x xxx x xxx x
x     x xxx x     x
x xxxxx xxx xxxxx x
x                 x
xxxxxxxxxxxxxxxxxxx